阿富汗: afghanistan|ａｆｇｈａｎｉｓｔａｎ|Ａｆｇｈａｎｉｓｔａｎ|ＡＦＧＨＡＮＩＳＴＡＮ|阿富汗
阿爾巴尼亞: albania|ａｌｂａｎｉａ|Ａｌｂａｎｉａ|ＡＬＢＡＮＩＡ|阿爾巴尼亞
阿爾及利亞: algeria|ａｌｇｅｒｉａ|Ａｌｇｅｒｉａ|ＡＬＧＥＲＩＡ|阿爾及利亞
安道爾: the principality of andorra|andorra|ａｎｄｏｒｒａ|Ａｎｄｏｒｒａ|ＡＮＤＯＲＲＡ|安道爾
安哥拉: angola|the republic of angola|ａｎｇｏｌａ|Ａｎｇｏｌａ|ＡＮＧＯＬＡ|安哥拉
阿根廷: argentina|republic of argentina|ａｒｇｅｎｔｉｎａ|Ａｒｇｅｎｔｉｎａ|ＡＲＧＥＮＴＩＮＡ|阿根廷
奧地利: austria|the republic of austria|ａｕｓｔｒｉａ|Ａｕｓｔｒｉａ|ＡＵＳＴＲＩＡ|奧地利
巴哈馬: bahamas|the commonwealth of the bahamas|ｂａｈａｍａｓ|Ｂａｈａｍａｓ|ＢＡＨＡＭＡＳ|巴哈馬
巴林: bahrain|the kingdom of bahrain|ｂａｈｒａｉｎ|Ｂａｈｒａｉｎ|ＢＡＨＲＡＩＮ|巴林
巴貝多: barbados|ｂａｒｂａｄｏｓ|Ｂａｒｂａｄｏｓ|ＢＡＲＢＡＤＯＳ|巴巴多斯|巴貝多
比利時: belgium|the kingdom of belgium|ｂｅｌｇｉｕｍ|Ｂｅｌｇｉｕｍ|ＢＥＬＧＩＵＭ|比利時|荷比盧
貝里斯: belize|ｂｅｌｉｚｅ|Ｂｅｌｉｚｅ|ＢＥＬＩＺＥ|伯利茲|貝里斯
貝南: benin|the republic of benin|ｂｅｎｉｎ|Ｂｅｎｉｎ|ＢＥＮＩＮ|貝寧|貝南
不丹: bhutan|the kingdom of bhutan|ｂｈｕｔａｎ|Ｂｈｕｔａｎ|ＢＨＵＴＡＮ|不丹
玻利維亞: bolivia|the republic of bolivia|ｂｏｌｉｖｉａ|Ｂｏｌｉｖｉａ|ＢＯＬＩＶＩＡ|玻利維亞
波札那: botswana|the republic of botswana|ｂｏｔｓｗａｎａ|Ｂｏｔｓｗａｎａ|ＢＯＴＳＷＡＮＡ|博茨瓦納|波札那
巴西: brazil|the federative republic of brazil|ｂｒａｚｉｌ|Ｂｒａｚｉｌ|ＢＲＡＺＩＬ|巴西
汶萊: brunei|brunei darussalam|ｂｒｕｎｅｉ|Ｂｒｕｎｅｉ|ＢＲＵＮＥＩ|汶萊|文萊
保加利亞: bulgaria|the republic of bulgaria|ｂｕｌｇａｒｉａ|Ｂｕｌｇａｒｉａ|ＢＵＬＧＡＲＩＡ|保加利亞
柬埔寨: cambodia|kingdom of cambodia|ｃａｍｂｏｄｉａ|Ｃａｍｂｏｄｉａ|ＣＡＭＢＯＤＩＡ|柬埔寨|高棉
喀麥隆: cameroun|ｃａｍｅｒｏｕｎ|Ｃａｍｅｒｏｕｎ|ＣＡＭＥＲＯＵＮ|喀麥隆
加拿大: canada|the dominion of canada|ｃａｎａｄａ|Ｃａｎａｄａ|ＣＡＮＡＤＡ|加拿大|楓葉國|楓葉之國
維德角: cape verde islands|cape verde|佛得角|維德角
中非共和國: central africa|the central african republic|central african republic|中非共和國
查德: chad|ｃｈａｄ|Ｃｈａｄ|ＣＨＡＤ|乍得|查德
智利: chile|republic of chile|ｃｈｉｌｅ|Ｃｈｉｌｅ|ＣＨＩＬＥ|智利
哥倫比亞: colombia|the republic of colombia|ｃｏｌｏｍｂｉａ|Ｃｏｌｏｍｂｉａ|ＣＯＬＯＭＢＩＡ|哥倫比亞
葛摩: comoros|union of comoros|ｃｏｍｏｒｏｓ|Ｃｏｍｏｒｏｓ|ＣＯＭＯＲＯＳ|科摩羅|葛摩
剛果共和國: congo|the republic of congo|ｃｏｎｇｏ|Ｃｏｎｇｏ|ＣＯＮＧＯ|剛果共和國
哥斯大黎加: costa rica|the republic of costa rica|哥斯達黎加|哥斯大黎加
象牙海岸: ivory coast|象牙海岸
古巴: cuba|the republic of cuba|ｃｕｂａ|Ｃｕｂａ|ＣＵＢＡ|古巴
賽普勒斯: cyprus|the republic of cyprus|ｃｙｐｒｕｓ|Ｃｙｐｒｕｓ|ＣＹＰＲＵＳ|塞浦路斯|賽普勒斯
捷克: czechoslovakia|ｃｚｅｃｈｏｓｌｏｖａｋｉａ|Ｃｚｅｃｈｏｓｌｏｖａｋｉａ|ＣＺＥＣＨＯＳＬＯＶＡＫＩＡ|捷克
丹麥: denmark|the kingdom of denmark|ｄｅｎｍａｒｋ|Ｄｅｎｍａｒｋ|ＤＥＮＭＡＲＫ|丹麥
吉布地: djibouti|the republic of djibouti|ｄｊｉｂｏｕｔｉ|Ｄｊｉｂｏｕｔｉ|ＤＪＩＢＯＵＴＩ|吉布提|吉布地
厄瓜多: ecuador|republic of ecuador|ｅｃｕａｄｏｒ|Ｅｃｕａｄｏｒ|ＥＣＵＡＤＯＲ|厄瓜多爾|厄瓜多
埃及: egypt|ｅｇｙｐｔ|Ｅｇｙｐｔ|ＥＧＹＰＴ|埃及|阿拉伯埃及共和國
薩爾瓦多: el salvador|the republic of el salvador|薩爾瓦多
斐濟: fiji|the republic of the fiji islands|ｆｉｊｉ|Ｆｉｊｉ|ＦＩＪＩ|斐濟
芬蘭: finland|the republic of finland|ｆｉｎｌａｎｄ|Ｆｉｎｌａｎｄ|ＦＩＮＬＡＮＤ|芬蘭
法國: france|the republic of france|ｆｒａｎｃｅ|Ｆｒａｎｃｅ|ＦＲＡＮＣＥ|法國|法蘭西共和國|法方|德法|英法
加彭: gabon|the gabonese republic|ｇａｂｏｎ|Ｇａｂｏｎ|ＧＡＢＯＮ|加蓬|加彭
甘比亞: gambia|the republic of the gambia|ｇａｍｂｉａ|Ｇａｍｂｉａ|ＧＡＭＢＩＡ|岡比亞|甘比亞
喬治亞: georgia|ｇｅｏｒｇｉａ|Ｇｅｏｒｇｉａ|ＧＥＯＲＧＩＡ|喬治亞|佐治亞
迦納: ghana|the republic of ghana|ｇｈａｎａ|Ｇｈａｎａ|ＧＨＡＮＡ|加納|迦納
希臘: greece|ｇｒｅｅｃｅ|Ｇｒｅｅｃｅ|ＧＲＥＥＣＥ|希臘
格瑞那達: grenada|ｇｒｅｎａｄａ|Ｇｒｅｎａｄａ|ＧＲＥＮＡＤＡ|格林納達|格瑞那達
瓜地馬拉: guatemala|the republic of guatemala|ｇｕａｔｅｍａｌａ|Ｇｕａｔｅｍａｌａ|ＧＵＡＴＥＭＡＬＡ|危地馬拉|瓜地馬拉
幾內亞: guinea|the republic of guinea|ｇｕｉｎｅａ|Ｇｕｉｎｅａ|ＧＵＩＮＥＡ|畿內亞|幾內亞
幾內亞比索: guinea bissau|the republic of guinea bissau|畿內亞比紹|幾內亞比索
海地: haiti|the republic of haiti|ｈａｉｔｉ|Ｈａｉｔｉ|ＨＡＩＴＩ|海地
宏都拉斯: honduras|the republic of honduras|ｈｏｎｄｕｒａｓ|Ｈｏｎｄｕｒａｓ|ＨＯＮＤＵＲＡＳ|洪都拉斯|宏都拉斯
匈牙利: hungary|the republic of hungary|ｈｕｎｇａｒｙ|Ｈｕｎｇａｒｙ|ＨＵＮＧＡＲＹ|匈牙利
冰島: iceland|the republic of iceland|ｉｃｅｌａｎｄ|Ｉｃｅｌａｎｄ|ＩＣＥＬＡＮＤ|冰島
印度: india|ｉｎｄｉａ|Ｉｎｄｉａ|ＩＮＤＩＡ|印度
印尼: indonesia|the republic of indonesia|ｉｎｄｏｎｅｓｉａ|Ｉｎｄｏｎｅｓｉａ|ＩＮＤＯＮＥＳＩＡ|印尼
伊朗: iran|islamic republic of iran|ｉｒａｎ|Ｉｒａｎ|ＩＲＡＮ|伊朗
伊拉克: iraq|the republic of iraq|ｉｒａｑ|Ｉｒａｑ|ＩＲＡＱ|伊拉克
愛爾蘭: ireland|republic of ireland|ｉｒｅｌａｎｄ|Ｉｒｅｌａｎｄ|ＩＲＥＬＡＮＤ|愛爾蘭
義大利: italy|the republic of italy|ｉｔａｌｙ|Ｉｔａｌｙ|ＩＴＡＬＹ|意大利|義大利
牙買加: jamaica|ｊａｍａｉｃａ|Ｊａｍａｉｃａ|ＪＡＭＡＩＣＡ|牙買加
日本: japan|nippon|ｊａｐａｎ|Ｊａｐａｎ|ＪＡＰＡＮ|日本|日方|中日|台日|美日|日韓
約旦: jordan|the hashemite kingdom of jordan|ｊｏｒｄａｎ|Ｊｏｒｄａｎ|ＪＯＲＤＡＮ|約旦
肯亞: kenya|the republic of kenya|ｋｅｎｙａ|Ｋｅｎｙａ|ＫＥＮＹＡ|肯尼亞|肯亞
吉里巴斯: kiribati|the republic of kiribati|ｋｉｒｉｂａｔｉ|Ｋｉｒｉｂａｔｉ|ＫＩＲＩＢＡＴＩ|基里巴斯|吉里巴斯
科威特: kuwait|the state of kuwait|ｋｕｗａｉｔ|Ｋｕｗａｉｔ|ＫＵＷＡＩＴ|科威特
黎巴嫩: lebanon|the republic of lebanonar|ｌｅｂａｎｏｎ|Ｌｅｂａｎｏｎ|ＬＥＢＡＮＯＮ|黎巴嫩
賴索托: lesotho|the kingdom of lesotho|ｌｅｓｏｔｈｏ|Ｌｅｓｏｔｈｏ|ＬＥＳＯＴＨＯ|萊索托|賴索托
賴比瑞亞: liberia|the republic of liberia|ｌｉｂｅｒｉａ|Ｌｉｂｅｒｉａ|ＬＩＢＥＲＩＡ|利比里亞|賴比瑞亞
利比亞: libya|libya arab jamahiriya|the great socialist people s libyan arab jamahiriya|ｌｉｂｙａ|Ｌｉｂｙａ|ＬＩＢＹＡ|利比亞
盧森堡: luxemburg|ｌｕｘｅｍｂｕｒｇ|Ｌｕｘｅｍｂｕｒｇ|ＬＵＸＥＭＢＵＲＧ|盧森堡|荷比盧
馬達加斯加: madagascar|ｍａｄａｇａｓｃａｒ|Ｍａｄａｇａｓｃａｒ|ＭＡＤＡＧＡＳＣＡＲ|馬達加斯加
馬拉威: malawi|the republic of malawi|ｍａｌａｗｉ|Ｍａｌａｗｉ|ＭＡＬＡＷＩ|馬拉維|馬拉威
馬來西亞: malaysia|ｍａｌａｙｓｉａ|Ｍａｌａｙｓｉａ|ＭＡＬＡＹＳＩＡ|馬來西亞|大馬
馬爾地夫: maldives|the republic of maldives|ｍａｌｄｉｖｅｓ|Ｍａｌｄｉｖｅｓ|ＭＡＬＤＩＶＥＳ|馬爾代夫|馬爾地夫
馬利: mali|the republic of mali|ｍａｌｉ|Ｍａｌｉ|ＭＡＬＩ|馬里|馬利
馬爾他: malta|the republic of malta|ｍａｌｔａ|Ｍａｌｔａ|ＭＡＬＴＡ|馬耳他|馬爾他
馬紹爾群島: marshall islands|the republic of marshall island|馬紹爾群島
茅利塔尼亞: mauritania|mauritanie|the islamic republic of mauritania|ｍａｕｒｉｔａｎｉａ|Ｍａｕｒｉｔａｎｉａ|ＭＡＵＲＩＴＡＮＩＡ|ｍａｕｒｉｔａｎｉｅ|Ｍａｕｒｉｔａｎｉｅ|ＭＡＵＲＩＴＡＮＩＥ|毛里塔尼亞|茅利塔尼亞
模里西斯: mauritius|maurice|the republic of mauritius|ｍａｕｒｉｔｉｕｓ|Ｍａｕｒｉｔｉｕｓ|ＭＡＵＲＩＴＩＵＳ|ｍａｕｒｉｃｅ|Ｍａｕｒｉｃｅ|ＭＡＵＲＩＣＥ|毛里求斯|毛里裘斯|模里西斯
墨西哥: mexico|the united states of mexico|ｍｅｘｉｃｏ|Ｍｅｘｉｃｏ|ＭＥＸＩＣＯ|墨西哥
摩納哥: monaco|the principality of monaco|ｍｏｎａｃｏ|Ｍｏｎａｃｏ|ＭＯＮＡＣＯ|摩納哥
摩洛哥: morocco|the kingdom of morocco|ｍｏｒｏｃｃｏ|Ｍｏｒｏｃｃｏ|ＭＯＲＯＣＣＯ|摩洛哥
莫三比克: mozambique|the republic of mozambique|ｍｏｚａｍｂｉｑｕｅ|Ｍｏｚａｍｂｉｑｕｅ|ＭＯＺＡＭＢＩＱＵＥ|莫桑比克|莫三比克
緬甸: burma|myanma|myanmar|the union of myanmar|ｂｕｒｍａ|Ｂｕｒｍａ|ＢＵＲＭＡ|ｍｙａｎｍａ|Ｍｙａｎｍａ|ＭＹＡＮＭＡ|ｍｙａｎｍａｒ|Ｍｙａｎｍａｒ|ＭＹＡＮＭＡＲ|緬甸
納米比亞: namibia|ｎａｍｉｂｉａ|Ｎａｍｉｂｉａ|ＮＡＭＩＢＩＡ|那米比亞|納米比亞
諾魯: nauru|ｎａｕｒｕ|Ｎａｕｒｕ|ＮＡＵＲＵ|瑙魯|諾魯|天堂島
尼泊爾: nepal|the kingdom of nepal|ｎｅｐａｌ|Ｎｅｐａｌ|ＮＥＰＡＬ|尼泊爾
荷蘭: netherlands|the kingdom of the netherlands|nederlands|ｎｅｔｈｅｒｌａｎｄｓ|Ｎｅｔｈｅｒｌａｎｄｓ|ＮＥＴＨＥＲＬＡＮＤＳ|荷蘭|荷比盧
紐西蘭: new zealand|新西蘭|紐西蘭|紐澳
尼加拉瓜: nicaragua|the republic of nicaragua|ｎｉｃａｒａｇｕａ|Ｎｉｃａｒａｇｕａ|ＮＩＣＡＲＡＧＵＡ|尼加拉瓜
尼日: niger|the republic of niger|ｎｉｇｅｒ|Ｎｉｇｅｒ|ＮＩＧＥＲ|尼日
奈及利亞: nigeria|the federal republic of nigeria|ｎｉｇｅｒｉａ|Ｎｉｇｅｒｉａ|ＮＩＧＥＲＩＡ|尼日利亞|奈及利亞
挪威: norway|the kingdom of norway|ｎｏｒｗａｙ|Ｎｏｒｗａｙ|ＮＯＲＷＡＹ|挪威
阿曼: oman|the sultanate of oman|ｏｍａｎ|Ｏｍａｎ|ＯＭＡＮ|阿曼
巴基斯坦: pakistan|the islamic republic of pakistan|ｐａｋｉｓｔａｎ|Ｐａｋｉｓｔａｎ|ＰＡＫＩＳＴＡＮ|巴基斯坦
巴布亞紐幾內亞: papua new guinea|the independent state of papua new guinea|巴布亞新畿內亞|巴布亞紐幾內亞|巴布亞新幾內亞
巴拉圭: paraguay|the republic of paraguay|ｐａｒａｇｕａｙ|Ｐａｒａｇｕａｙ|ＰＡＲＡＧＵＡＹ|巴拉圭
秘魯: peru|the republic of peru|ｐｅｒｕ|Ｐｅｒｕ|ＰＥＲＵ|秘魯
菲律賓: philippines|republic of the philippines|ｐｈｉｌｉｐｐｉｎｅｓ|Ｐｈｉｌｉｐｐｉｎｅｓ|ＰＨＩＬＩＰＰＩＮＥＳ|菲律賓|菲方|菲國
波蘭: poland|polska|ｐｏｌａｎｄ|Ｐｏｌａｎｄ|ＰＯＬＡＮＤ|ｐｏｌｓｋａ|Ｐｏｌｓｋａ|ＰＯＬＳＫＡ|波蘭
葡萄牙: portugal|a republica portuguesa|the portuguese republic|ｐｏｒｔｕｇａｌ|Ｐｏｒｔｕｇａｌ|ＰＯＲＴＵＧＡＬ|葡萄牙|葡方
卡達: qatar|the state of qatar|ｑａｔａｒ|Ｑａｔａｒ|ＱＡＴＡＲ|卡塔爾|卡達
羅馬尼亞: romania|ｒｏｍａｎｉａ|Ｒｏｍａｎｉａ|ＲＯＭＡＮＩＡ|羅馬尼亞
俄羅斯: russia|the russian federation|russian federation|ｒｕｓｓｉａ|Ｒｕｓｓｉａ|ＲＵＳＳＩＡ|俄羅斯|俄方|俄國|美俄
盧安達: rwanda|the republic of rwanda|ｒｗａｎｄａ|Ｒｗａｎｄａ|ＲＷＡＮＤＡ|盧旺達|盧安達
聖露西亞: st lucia|saint lucia|聖盧西亞|聖露西亞
聖馬利諾: san marino|the republic of san marino|聖馬力諾|聖馬利諾
聖多美和普林西比: sao tome and principe|the democratic republic of sao tome and principe|聖多美及普林西比|聖多美與普林西比|聖多美和普林西比|聖多美普林西比|República Democrática de São Tomé e Príncipe|Democratic Republic of Sao Tome and Principe|聖普
沙烏地阿拉伯: saudi arabia|kingdom of saudi arabia|沙特亞拉伯|沙特阿拉伯|沙烏地阿拉伯
塞內加爾: senegal|ｓｅｎｅｇａｌ|Ｓｅｎｅｇａｌ|ＳＥＮＥＧＡＬ|塞內加爾
塞席爾: seychelles|republic of seychelles|ｓｅｙｃｈｅｌｌｅｓ|Ｓｅｙｃｈｅｌｌｅｓ|ＳＥＹＣＨＥＬＬＥＳ|塞席爾|塞舌爾|賽席爾
獅子山: lion rock|獅子山
新加坡: singapore|the republic of singapore|ｓｉｎｇａｐｏｒｅ|Ｓｉｎｇａｐｏｒｅ|ＳＩＮＧＡＰＯＲＥ|新加坡|星加坡|星國|星方
索馬利亞: somalia|the somali republic|ｓｏｍａｌｉａ|Ｓｏｍａｌｉａ|ＳＯＭＡＬＩＡ|索馬里|索馬利亞
南非: south africa|republic of south africa|南非|黃金之國
西班牙: spain|ｓｐａｉｎ|Ｓｐａｉｎ|ＳＰＡＩＮ|西班牙
斯里蘭卡: sri lanka|the democratic socialist republic of sri lanka|斯里蘭卡
蘇丹: sudan|the republic of the sudan|ｓｕｄａｎ|Ｓｕｄａｎ|ＳＵＤＡＮ|蘇丹
蘇利南: suriname|the republic of suriname|ｓｕｒｉｎａｍｅ|Ｓｕｒｉｎａｍｅ|ＳＵＲＩＮＡＭＥ|蘇里南|蘇利南
史瓦濟蘭: swaziland|the kingdom of swaziland|ｓｗａｚｉｌａｎｄ|Ｓｗａｚｉｌａｎｄ|ＳＷＡＺＩＬＡＮＤ|史雅濟蘭|斯威士蘭|史瓦濟蘭
瑞典: sweden|the kingdom of sweden|ｓｗｅｄｅｎ|Ｓｗｅｄｅｎ|ＳＷＥＤＥＮ|瑞典
瑞士: switzerland|swiss confederation|ｓｗｉｔｚｅｒｌａｎｄ|Ｓｗｉｔｚｅｒｌａｎｄ|ＳＷＩＴＺＥＲＬＡＮＤ|瑞士
敘利亞: syria|the syrian arab republic|syria arab republic|ｓｙｒｉａ|Ｓｙｒｉａ|ＳＹＲＩＡ|敘利亞
坦尚尼亞: tanzania|united republic of tanzania|ｔａｎｚａｎｉａ|Ｔａｎｚａｎｉａ|ＴＡＮＺＡＮＩＡ|坦桑利亞|坦尚尼亞
泰國: thailand|the kingdom of thailand|ｔｈａｉｌａｎｄ|Ｔｈａｉｌａｎｄ|ＴＨＡＩＬＡＮＤ|泰國|泰王國
東帝汶: east timor|democratic republic of timor leste|timor leste|東帝汶
多哥: togo|the republic of togo|ｔｏｇｏ|Ｔｏｇｏ|ＴＯＧＯ|多哥
東加: tonga|the kingdom of tonga|ｔｏｎｇａ|Ｔｏｎｇａ|ＴＯＮＧＡ|湯加|東加
吐瓦魯: tuvalu|ｔｕｖａｌｕ|Ｔｕｖａｌｕ|ＴＵＶＡＬＵ|吐瓦魯|圖瓦盧
烏干達: uganda|the republic of uganda|ｕｇａｎｄａ|Ｕｇａｎｄａ|ＵＧＡＮＤＡ|烏干達
英國: united kingdom of great britain and northern ireland|united kingdom|britain|ｂｒｉｔａｉｎ|Ｂｒｉｔａｉｎ|ＢＲＩＴＡＩＮ|英格蘭|大不列顛與北愛爾蘭聯合王國|英國|英方|美英|英美|英法
美國: the united states of america|usa|united states|america|ｕｓａ|Ｕｓａ|ＵＳＡ|ａｍｅｒｉｃａ|Ａｍｅｒｉｃａ|ＡＭＥＲＩＣＡ|美利堅合眾國|美國|U.S.|美方|美俄|英美|美英|美日
烏拉圭: uruguay|the oriental republic of uruguay|ｕｒｕｇｕａｙ|Ｕｒｕｇｕａｙ|ＵＲＵＧＵＡＹ|烏拉圭
萬那杜: vanuatu|the republic of vanuatu|ｖａｎｕａｔｕ|Ｖａｎｕａｔｕ|ＶＡＮＵＡＴＵ|瓦努阿圖|萬那杜
委內瑞拉: venezuela|ｖｅｎｅｚｕｅｌａ|Ｖｅｎｅｚｕｅｌａ|ＶＥＮＥＺＵＥＬＡ|委內瑞拉
越南: vietnam|ｖｉｅｔｎａｍ|Ｖｉｅｔｎａｍ|ＶＩＥＴＮＡＭ|越南
葉門: yemen|ｙｅｍｅｎ|Ｙｅｍｅｎ|ＹＥＭＥＮ|也門|葉門
尚比亞: zambia|ｚａｍｂｉａ|Ｚａｍｂｉａ|ＺＡＭＢＩＡ|贊比亞|尚比亞
辛巴威: zimbabwe|ｚｉｍｂａｂｗｅ|Ｚｉｍｂａｂｗｅ|ＺＩＭＢＡＢＷＥ|津巴布韋|辛巴威
巴勒斯坦: palestine|ｐａｌｅｓｔｉｎｅ|Ｐａｌｅｓｔｉｎｅ|ＰＡＬＥＳＴＩＮＥ|巴勒斯坦|以巴
庫克群島: cook islands|庫克群島|科克群島
紐埃: niue|ｎｉｕｅ|Ｎｉｕｅ|ＮＩＵＥ|紐埃|紐威島
北韓: north korea|n korea|democratic people s of korea|北韓|北朝鮮|朝鮮人民共和國
南韓: south korea|s korea|republic of korea|韓國|korea|morning calm|ｋｏｒｅａ|Ｋｏｒｅａ|ＫＯＲＥＡ|南韓|南朝鮮|日韓
聖文森: st vincent ad the grenadines|saint vincent and the grenadines|聖文森特|聖文森
中國: people s republic of china|china|prc|the prc|ｃｈｉｎａ|Ｃｈｉｎａ|ＣＨＩＮＡ|ｐｒｃ|Ｐｒｃ|ＰＲＣ|中華人民共和國|陸方|中方|中國|陸生|陸客|陸配|中日
香港: hong kong special administrative region|hksar|sar|hong kong|hongkong|hk|ｈｋｓａｒ|Ｈｋｓａｒ|ＨＫＳＡＲ|ｓａｒ|Ｓａｒ|ＳＡＲ|ｈｏｎｇｋｏｎｇ|Ｈｏｎｇｋｏｎｇ|ＨＯＮＧＫＯＮＧ|ｈｋ|Ｈｋ|ＨＫ|香港|香江|港澳|港民|港台|台港
澳門: macau|macao|macau sar|ｍａｃａｕ|Ｍａｃａｕ|ＭＡＣＡＵ|ｍａｃａｏ|Ｍａｃａｏ|ＭＡＣＡＯ|澳門|港澳
梵蒂岡: the vatican|holy see vatican city state|the vatican city state|梵蒂岡|梵諦岡
台灣: taiwan|ｔａｉｗａｎ|Ｔａｉｗａｎ|ＴＡＩＷＡＮ|臺灣|台灣|中華民國|R.O.C.|我國|台日|港台|台港
安地卡及巴布達: 安地卡及巴布達|Antigua and Barbuda|安提瓜和巴布達|安地卡與巴布達|安地卡和巴布達|安提瓜和巴布达
亞美尼亞: 亞美尼亞|Armenia
澳洲: 澳洲|Australia|澳大利亞|紐澳
亞塞拜然: 亞塞拜然|Azerbaijan|阿塞拜疆
孟加拉國: 孟加拉|The People's Republic of Bangladesh|Bangladesh|孟加拉國
白俄: Беларусь|The Republic of Belarus|白俄
布吉納法索: 布吉納法索|Burkina Faso
蒲隆地: 蒲隆地|Burundi
克羅埃西亞: 克羅埃西亞|Croatia
剛果民主共和國: 剛果民主共和國|République démocratique du Congo|Democratic Republic of the Congo|民主剛果
多米尼克: 多米尼加|The Commonwealth of Dominica|多米尼克
多明尼加: 多明尼加|Dominican Republic|República Dominicana
赤道幾內亞: 赤道幾內亞|The Republic of Equatorial Guinea
厄利垂亞: 厄利垂亞|Eritrea
愛沙尼亞: 愛沙尼亞|The Republic of Estonia
衣索比亞: 衣索比亞|阿比西尼亞|Ethiopia|Abyssinia
德國: 德國|Germany|德意志聯邦|Bundesrepublik Deutschland|Deutschland|德方|德法
蓋亞那: 蓋亞那|Guyana
以色列: Iseral|以色列|以巴|以國
哈薩克: 哈薩克|Kazakhstan
吉爾吉斯: 吉爾吉斯|Кыргыз Республикасы|Кыргызская Республика|Kyrgyz Respublikasy
寮國: 寮國|寮人民民主共和國|Lao People's Dem Rep
拉脫維亞: Latvija|拉脫維亞
列支敦斯登: Fürstentum Liechtenstein|列支敦斯登|列支敦士登
立陶宛: Republic of Lithuania|Lietuvos Respublika|立陶宛
馬其頓: 馬其頓|Република Македонија|Republika Makedonija|Macedonia
密克羅尼西亞聯邦: 密克羅尼西亞|米克羅尼西亞|Federated States of Micronesia|FSM
摩爾多瓦: Moldova|摩爾多瓦|Republic of Moldova|Republica Moldova
蒙古國: 蒙古國|Mongolia|Монгол улс
蒙特內哥羅: 蒙特內哥羅|Montenegro|門的內哥羅|黑山
帛琉: Republic of Palau|Beluu er a Belau|帛琉
巴拿馬: 巴拿馬|la República de Panamá|Panama
聖克里斯多福與尼維斯: 聖克里斯多福與尼維斯|聖克里斯多福及尼維斯|聖克里斯多福和尼維斯|Saint Christopher (St. Kitts) and Nevis|Saint Christopher and Nevis|St. Christopher and Nevis|St. Kitts and Nevis|Saint Kitts and Nevis
聖文森及格瑞那丁: 聖文森及格瑞那丁|Saint Vincent and the Grenadines|St. Vincent and the Grenadines|聖文森與格瑞那丁|聖文森和格瑞那丁
薩摩亞: 薩摩亞|Samoa|Independent Samoa|West Samoa|Samoa Islands
塞爾維亞: 塞爾維亞|Република Србија|Republika Srbija|Republic of Serbia
斯洛伐克: Slovakia|斯洛伐克|Slovak Republic
斯洛維尼亞: 斯洛維尼亞|斯洛文尼亞 |Slovenija|Republika Slovenija|Slovenia
索羅門群島: 索羅門群島|Solomon Islands
南蘇丹: 南蘇丹|South Sudan,Republic of|Republic of South Sudan
塔吉克: 塔吉克|The Republic of Tajikistan
千里達及托巴哥: 千里達與托巴哥|千里達和托巴哥|特立尼達和多巴哥|特多國|Republic of Trinidad and Tobago|千里達及托巴哥
突尼西亞: 突尼西亞|Tunisian Republic
土耳其: Turkey|土耳其|Türkiye Cumhuriyeti
土庫曼: 土庫曼|Türkmenistan|Turkmenistan|土库曼斯坦
烏克蘭: 烏克蘭|Ukrane|Україна
烏茲別克: 乌兹别克斯坦|烏茲別克|Republic of Uzbekistan|O'zbekiston Respublikasi
撒拉威阿拉伯民主共和國: 撒拉威阿拉伯民主共和國|Sahrawi Arab Democratic Republic
西薩哈拉: Western Sahara|西薩哈拉
加泰隆尼亞: Catalunya|Catalonia|加泰隆尼亞
蘇格蘭: Scotland|Alba|蘇格蘭
莫洛伊斯蘭解放陣線: 莫洛國|Moro Islamic Liberation Front|MILF|莫洛民族解放陣線|摩洛伊斯兰解放阵线
科索沃: 科索夫|科索伏|Kosovo|科索沃
波赫: 波士尼亞與赫塞哥維納|Bosnia and Herzegovina|Bosnia-Herzegovina|波赫
前蘇聯: 蘇維埃社會主義共和國聯盟|Союз Советских Социалистических Республик|前蘇聯
阿拉伯聯合大公國: 阿聯|The United Arab Emirates|阿拉伯联合酋长国|阿拉伯聯合大公國
波多黎各: The Commonwealth of Puerto Rico|波多黎各